__,__,__,ss,__,__,ss,__,__,__,__,__,__,__,__,__,s3,__,__,__,
__,__,__,__,__,__,ss,##,##,##,__,##,##,##,##,__,s3,__,__,__,
__,__,__,__,__,__,__,__,__,__,__,__,__,__,__,__,s3,__,__,__,
__,__,ss,ss,__,##,##,##,##,__,__,##,##,__,##,##,##,__,__,__,
__,__,__,ss,__,##,__,__,__,__,__,__,__,__,__,__,##,__,##,s1,
__,__,__,ss,__,##,__,ss,##,ss,##,ss,##,##,##,##,##,__,__,##,
__,__,__,ss,__,$$,$$,$$,$$,$$,$$,$$,$$,$$,$$,$$,$$,__,__,__,
__,__,__,ss,$$,$$,$$,$$,$$,$$,$$,$$,$$,$$,$$,$$,$$,__,__,__,
__,__,__,##,ss,ss,ss,ss,##,##,##,##,##,$$,$$,$$,$$,##,##,##,
##,__,__,##,$$,$$,$$,$$,$$,$$,$$,$$,$$,$$,$$,$$,$$,__,__,__,
##,##,__,##,$$,$$,$$,$$,$$,$$,$$,$$,$$,$$,$$,$$,$$,__,__,__,
##,##,##,##,$$,$$,$$,$$,$$,$$,$$,$$,##,##,##,##,##,__,__,__,
##,##,##,##,##,##,$$,##,$$,##,$$,$$,$$,$$,$$,##,__,__,__,__,
##,##,##,##,$$,$$,$$,$$,$$,##,$$,$$,$$,$$,$$,##,__,__,__,__,
#0,s0,s0,s0,$$,ss,ss,ss,ss,##,ss,ss,$$,ss,ss,##,##,##,ss,##,
__,__,__,##,__,__,$$,$$,$$,$$,$$,$$,$$,$$,$$,$$,$$,$$,$$,##,
__,__,__,##,__,__,__,$$,$$,$$,$$,$$,$$,$$,$$,$$,$$,$$,$$,$$,
__,__,__,##,__,__,__,__,__,__,__,__,__,__,__,__,__,__,__,__,
__,__,__,##,__,__,__,__,__,__,__,__,__,__,__,__,__,__,__,__,
__,__,__,##,__,__,__,__,__,__,__,__,__,__,__,__,__,__,__,__