__,__,__,__,__,__,__,__,__,__,__,__,__,__,__,__,__,__,__,__,
__,__,__,$$,__,__,__,__,$$,__,__,__,__,__,__,__,__,__,$$,__,
__,__,$$,ss,$$,__,__,$$,ss,$$,__,__,__,__,__,__,__,$$,ss,$$,
__,$$,ss,ss,$$,__,$$,ss,ss,ss,$$,__,__,__,__,__,__,$$,ss,$$,
__,$$,ss,ss,ss,$$,ss,ss,ss,$$,$$,$$,$$,__,__,__,$$,ss,ss,$$,
__,$$,ss,ss,ss,$$,$$,ss,$$,$$,ss,ss,ss,$$,__,__,$$,ss,ss,$$,
$$,ss,ss,ss,ss,$$,__,$$,$$,$$,ss,ss,ss,$$,__,__,$$,ss,ss,$$,
$$,ss,ss,ss,ss,$$,__,__,$$,$$,ss,$$,$$,__,__,$$,ss,ss,ss,$$,
$$,ss,ss,ss,ss,$$,__,$$,ss,ss,ss,$$,__,__,__,$$,ss,ss,ss,$$,
$$,ss,ss,ss,ss,$$,__,$$,ss,ss,ss,$$,__,__,__,$$,ss,ss,$$,__,
$$,ss,ss,ss,$$,__,__,ss,ss,$$,$$,__,__,__,__,$$,ss,ss,$$,__,
$$,ss,ss,ss,$$,__,$$,ss,ss,$$,__,__,__,__,$$,ss,ss,ss,$$,__,
$$,ss,ss,ss,$$,$$,ss,ss,$$,__,__,__,__,__,__,$$,$$,$$,__,__,
$$,ss,ss,ss,$$,$$,ss,$$,__,__,$$,__,__,__,__,__,__,__,__,__,
$$,ss,ss,ss,$$,__,$$,__,__,$$,ss,$$,__,__,__,__,__,__,__,__,
__,$$,ss,ss,$$,__,__,__,__,$$,ss,ss,$$,__,__,__,__,__,__,__,
__,$$,ss,ss,$$,__,__,__,__,$$,ss,ss,ss,$$,$$,$$,$$,$$,__,__,
__,$$,ss,ss,$$,__,__,__,__,__,$$,ss,ss,ss,ss,ss,ss,ss,$$,__,
__,__,$$,ss,$$,__,__,__,__,__,__,$$,ss,ss,ss,ss,$$,$$,__,__,
__,__,__,$$,__,__,__,__,__,__,__,__,$$,$$,$$,$$,__,__,__,__
