__,__,__,__,__,__,__,__,__,__,__,__,__,__,__,__,__,__,__,__,
__,__,__,__,__,__,__,__,__,__,__,__,__,__,__,__,__,__,__,__,
__,__,__,__,__,__,__,__,__,__,__,__,__,__,__,__,__,__,__,__,
__,__,__,__,##,##,##,##,##,##,##,##,##,##,##,__,__,__,__,__,
__,__,__,##,##,##,##,##,##,##,##,##,ss,##,##,##,##,__,__,__,
__,__,##,##,##,##,##,##,##,##,##,##,##,##,##,ss,ss,s2,__,__,
__,__,##,##,$$,$$,$$,$$,$$,$$,$$,$$,$$,$$,$$,$$,$$,s2,__,__,
__,__,##,##,##,$$,$$,$$,$$,$$,##,$$,$$,$$,$$,$$,$$,s2,__,__,
__,##,##,##,##,##,$$,$$,$$,##,$$,##,$$,$$,$$,$$,$$,s2,__,__,
__,##,##,##,##,##,$$,$$,##,$$,$$,$$,##,$$,$$,$$,$$,s2,__,__,
__,##,##,##,##,##,$$,##,$$,$$,$$,$$,$$,##,$$,$$,$$,s2,__,__,
__,##,##,##,##,##,$$,$$,##,$$,$$,$$,##,$$,$$,$$,$$,s2,__,__,
__,##,##,##,##,$$,$$,$$,$$,##,$$,##,$$,$$,$$,$$,##,s2,__,__,
__,__,##,##,$$,$$,$$,$$,$$,$$,##,$$,$$,$$,$$,$$,##,##,__,__,
__,__,##,$$,$$,$$,$$,$$,$$,##,##,$$,$$,$$,$$,##,##,s0,s0,s0,
__,__,##,##,##,$$,$$,$$,$$,$$,$$,$$,$$,$$,##,##,__,__,__,__,
__,__,__,##,##,##,##,##,##,##,##,##,##,##,##,__,__,__,__,__,
__,__,__,__,__,__,__,__,__,__,__,__,__,__,__,__,__,__,__,__,
__,__,__,__,__,__,__,__,__,__,__,__,__,__,__,__,__,__,__,__,
__,__,__,__,__,__,__,__,__,__,__,__,__,__,__,__,__,__,__,__