__,__,__,__,__,__,__,__,__,__,__,__,__,__,__,__,__,__,__,__,
__,__,__,__,__,__,__,__,__,__,__,__,__,__,__,__,__,__,__,__,
__,##,##,__,__,__,__,__,##,__,__,##,__,__,__,__,__,##,##,__,
__,##,##,__,__,__,__,__,##,__,__,##,__,__,__,__,__,##,##,__,
__,##,##,__,__,__,__,__,##,__,__,##,__,__,__,__,__,##,##,__,
__,##,##,__,__,__,__,__,##,__,__,##,__,__,__,__,__,##,##,__,
__,##,##,__,__,__,__,__,##,__,__,##,__,__,__,__,__,##,##,__,
__,##,##,__,__,__,__,__,##,__,__,##,__,__,__,__,__,##,##,__,
__,##,##,__,__,__,__,__,##,__,__,##,__,__,__,__,__,##,##,__,
__,##,##,__,__,__,__,__,##,ss,ss,##,__,__,__,__,__,##,##,__,
__,__,__,__,__,__,__,__,__,__,__,__,__,__,__,__,__,__,__,__,
s0,##,##,__,__,__,__,__,##,s0,s0,##,__,__,__,__,__,##,##,s0,
__,##,##,__,__,__,__,__,##,__,__,##,__,__,__,__,__,##,##,__,
__,##,##,__,__,__,__,__,##,__,__,##,__,__,__,__,__,##,##,__,
__,##,##,__,__,__,__,__,##,__,__,##,__,__,__,__,__,##,##,__,
__,##,##,__,__,__,__,__,##,__,__,##,__,__,__,__,__,##,##,__,
__,##,##,__,__,__,__,__,##,__,__,##,__,__,__,__,__,##,##,__,
__,__,__,__,__,__,__,__,__,__,__,__,__,__,__,__,__,__,__,__,
__,__,__,__,__,__,__,__,__,__,__,__,__,__,__,__,__,__,__,__,
__,__,__,__,__,__,__,__,__,__,__,__,__,__,__,__,__,__,__,__