__,__,__,__,__,__,__,__,__,__,__,__,__,__,__,__,__,__,__,__,
__,__,__,__,__,__,__,__,__,__,__,__,__,__,__,__,__,__,__,__,
__,__,__,__,__,__,__,__,##,##,##,__,__,__,__,$$,$$,$$,__,__,
__,__,__,ss,ss,ss,__,__,##,##,##,__,__,__,__,$$,$$,$$,__,__,
__,__,__,ss,ss,ss,__,__,##,##,##,__,__,__,__,$$,$$,$$,__,__,
__,__,__,ss,ss,ss,__,__,__,__,__,__,__,__,__,__,__,__,__,__,
__,__,__,__,__,__,__,__,__,__,__,##,##,##,__,__,==,==,==,__,
$$,$$,$$,__,__,__,__,__,__,__,__,##,##,##,__,__,==,==,==,__,
$$,$$,$$,__,__,__,__,__,__,__,__,##,##,##,__,__,==,==,==,__,
$$,$$,$$,__,__,__,ss,ss,ss,__,__,__,__,__,##,##,##,__,__,__,
__,__,__,__,__,__,ss,ss,ss,__,__,__,__,__,##,##,##,__,__,__,
__,__,__,__,__,__,ss,ss,ss,__,__,__,__,__,##,##,##,__,__,__,
__,__,__,__,__,__,__,__,__,__,__,__,__,__,__,__,__,__,__,__,
__,ss,ss,ss,__,__,__,__,__,__,__,__,__,__,__,__,__,__,__,__,
__,ss,ss,ss,__,__,__,__,__,##,##,##,__,__,__,__,__,__,__,__,
__,ss,ss,ss,__,__,__,__,__,##,##,##,__,__,__,__,__,__,__,__,
__,__,__,__,__,__,__,__,__,##,##,##,__,__,__,__,__,__,__,__,
__,__,__,__,##,##,##,__,__,__,__,__,__,__,__,==,==,==,__,__,
__,__,__,__,##,##,##,__,__,__,__,__,__,__,__,==,==,==,__,__,
__,__,__,__,##,##,##,__,__,__,__,__,__,__,__,==,==,==,__,__
